00000000000000000000000000000000
00000000000000000000000000000000
11001100110011001100110011001100
01111111111111111111111111111111
00111111111111111111111111111110
00100010001000100010001000100010
01100010001000100010001000100010
01000000000000000000000000000010
01440000000000000000000000004410
01440000000000000000000000004410
01111111111111111111111111111110
00000000000000000000000000000000
00000000000000000000000000000000
00000000000000000000000000000000
00000000000000000000000000000000
00000000000000000000000000000000
00000000000000000000000000000000
00000000000000000000000000000000
00000000000000000000000000000000
01111111111111111111111111111110
01000000000000000000000000000010
01000000000000000000000000000010
01000000000000000000000000111110
01000000000000000000000000111110
01004400000000000000000000004410
01054400000000000000000000004410
01151100000000111100000000111110
01151100000000111100000000111110
01050000000000000000000000000010
01050000000000000000000000000010
01050000000000000011111111000010
01050000000000000011111111000010
