01000000000000000000000000000010
01000000000000000000000000000010
01000011111661111100001111000010
01000011111111111100001111000010
01000000000000000000000000000010
01000000000000000000000000000010
01166100000000000011111111111110
01111100000000000011111111111110
01440000000000000000000000004410
01440000000000000000000000004410
01111111110000000000000000111110
01111111110000000000000000111110
01000000000000000000000000000010
01000000000000000000000000000010
01111111111111111111111111111110
00000000000110000000000000000000
00000000000000000000000000000000
00011110111111111110111111101110
01110011101100110011101100111010
01000001100000000001100000011010
01000000000000000000000000000010
01000000000000000000000000000010
01000000000000000000000000000010
01000000000000000000000000000010
01440000000000000000000000004410
01440000000000000000000000004410
01111100001111000011110000111110
00000100001001000010010000100000
00000111111001111110011111100000
00000000000000000000000000000000
00000000000000000000000000000000
00000000000000000000000000000000
