00000000000000000000000000000000
00000000000000000000000000000000
11001100110011001100110011001100
11111111111111111111111111111111
00111111111111111111111111111110
00100010001000100010001000100010
01100010001000100010001000100010
01000000000000000000000000000010
01440000000000000000000000004410
01440000000000000000000000004410
01111111111111111111111111111110
00000000000000000000000000000000
00000000000000000000000000000000
00000000000000000000000000000000
00000000000000000000000000000000
00000000000000000000000000000000
00000000000000000000000000000000
01111111111111111111111111111110
01000000000000000000000000000010
01000000000000000000000000000010
01000000000000000000000000000010
01000000000000000000000000000010
01000000001111166116611111000010
01000000111000111111110001110010
01440000001000000000000001000010
01440000001111111111111001000010
01111100000000000000001001000010
00000111000000000000001001001110
00000100000000000000001001000010
00000100000000000000001001000010
00000111111111111111111001000010
00000000000000000000000001110010
