00000000000000000000000000000000
00000000000000000000000000000000
00000011111111111100000000000000
01111112211221122111111111111110
01000000000000000000000000000010
01000000000000000000000000000010
01000011111111111111110000111110
01000011111111111111110000111110
01000000000000001100000000004410
01000000000000001100000000004410
01111111110000001100001111111110
01111111110000001100001111111110
01000000000000001100000000000010
01000000000000003300000000000010
01000011111111111111111111111110
01000012211221122112211111111110
01000000000000000000000000000010
01000000000000000000000000000010
01111111111111111111110000000010
01111111111111111111110000000010
01000000000000000000000000000010
01000000000000000000000000000010
01000000000000000000001111000010
01000000000000000000001111000010
01000000000000000000000000000010
01000000000000000000000000000010
01000011111111111111110000000010
01000011111111111111110000000010
01000000000000000000000000000010
01000000000000000000000000000010
01111100000000000000000000000010
01111100000000000000000000000010
