11111111111111111111111111000011
11111111111111111111111111000011
11000000001101000000000000000010
11000000001001000000000000001110
11000000001001000000000000000010
11000000001001000000000000000010
11000000001001000011111661000010
11000000111001110010001111110010
11440000001001000010000001000010
11440000001111000010011111000010
11111100000000000010010000000010
10000111000000001110010000001110
10000100000000000010010000000010
10000100000000000010010000000010
10000116611111166110011111111110
10000011110000111100000000000000
10000000000000000000000000000000
11111111111111111111111111111110
11000000000000000000000000000010
11000000000000000000000000000010
11000000000000000000000000000010
11000000000000000000000000000010
11000000000000000000000000000010
11000000000000000000000000000010
11000000000000000000000000000010
11000000000000000000000000000010
11000000000000000000000000000010
11000000000000000000000000000010
11000000000000000000000000000010
11000000000000000000000000000010
11111111111111111111111111111110
11111111111111111111111111111111
