01050000000000000000000000000010
01050000000000000000000000000010
01050000000000111100000000000010
01050000000000111100000000000010
01050000000000000000000000000010
01050000000000000000000000000010
01111166661111111111110000111110
01111111111111111111110000111110
01000000000000000000000000000010
01000000000000000000000000000010
01000000000000000000001111000010
01000000000000000000001111000010
01000000000000000000000000000010
01000000000000000000000000000010
01111100001111666611111111111110
01111100001111111111111111111110
01000000000000000000000000000010
01000000000000000000000000000010
01000011110000000000000000000010
01000011110000000000000000000010
01000000000000000000000000000010
01000000000000000000000000000010
01111111111111111100000000111110
01111111111111111100000000111110
01000000000000000000000000004410
01000000000000000000000000004410
01000000000000000011111111111110
01000000000000000011111111111110
01000000000000000000000000000010
01000000000000000000000000000010
01000011116666111100000000000010
01000011111111111100000000000010
