00000000000000000000000000000000
00000000000000000000000000000000
01111111111111111111111111111110
01111111111111111111111111111110
01000000000000000000000000000010
01000000000000000000000000000010
01000000000000000000000000000010
01000000000000000000000000000010
01000000000000000000000000004410
01000000000000000000000000004410
01004400000000000000000000111110
01004400000000000000000000100000
01111111111111111111111111100000
00000000000000000000000000000000
00000000000000000000000000000000
00000000000000000000000000000000
00000000000000000000000000000000
00000000000000000000000000000000
00000000000000000000000000000000
01111111111111111111111111111110
01000000000000000000000000000010
11000000000000000000000000000010
01111100000000000000000000000010
01111100000000000000000000000010
01440000000000000000000000000010
01440000000000000000000000000010
01111100000000000000000000000010
01111100000000000000000000000010
01000000000000000000000044000010
01000000000000000000000044000010
01111111111111111111111111111110
00000000000000000000000000000000
