01000000000000000000000000000010
01000000000000000000000000000010
01111111111111000011111111000010
01111111111111000011111111000010
01000000000000000000000000000010
01000000000000000000000000000010
01000000000000000000000000111110
01000000000000000000000000111110
01000000000000000000000000000010
01000000000000000000000000000010
01000011111111111111111111000010
01000011111111111111111111000010
01000000000000001100000000000010
01000000000000001100000000000010
01111100000000001100000000111110
01111100000000001100000000111110
01000000000000001100000000000010
01000000000000003300000000000010
01000011110000111111111111000010
01000011110000111111111111000010
01000000000000000000110000000010
01000000000000000000110000000010
01111111111111000000110000111110
01111111111111000000110000111110
01000000000000000000110000000010
01000000000000000000330000000010
01000000001111111111111111000010
01000000001111111111111111000010
01000000000000001100000000000010
01000000000000001100000000000010
01111111110000001100000000111110
01111112210000001100000000111110
