11111111111111111111111111111111
11111111111111111111111111111111
10011001100110011001100110011111
10011001100110011001100110011111
10000001100000000001100110011111
00000001100000000000000110011111
00000001100000000000000110011111
00000000000000000000000000044111
00000000000000000000000000044111
00000000000000000000000000044111
00001111111100001111111111111111
00000100010000000100010001000100
00000100010000000100010001000100
22222122212222222122212221222122
11111111111111111111111111111111
10000000000000000000000000000001
10000000000000000000000000000001
10000000000000000111111111111111
11100000000000000100000000000000
11111111111111100100000000000000
11000000000000100100000000000000
11000000000000100100000000000000
11000000001111100100000000111100
11000000001111100100000011100100
11000000000044100144000000100100
11000000000044100144000000100100
11000011111111100111110000100100
11000011111111100000010011100111
11000000000000100000010000100100
11000000000000100000010000100100
11000000000000100000010000100116
11000000000000111111111100111111
