11111111111111111111111111111111
11111111111111111111111111111111
11011001100110011001100110011001
11011001100110011001100110011001
11000001100000011001100000000001
11000000000000011000000000000000
11000000000000011000000000000000
11000000000000000000000000000000
11444000000000000000000000000000
11444000000000000000000000000000
11111111111111111111000011111111
00000100010001000100000001000100
01000100010001000100000001000100
21222122212221222122222221222122
11111111111111111111111111111111
11111111111111000000000000000001
10000000000000000000000000000001
10000000000000000000000000000001
10000000000000000000000000000001
11111111111111111111111111111111
11000000000000000000000000000011
11000000000000000000000000000011
11111100000000000000001111000011
11111100000000000000001111000011
11440000000000000000000000000011
11440000000000000000000000000011
11111100000000000000000000000011
11111100000000000000000000000011
11000000000000000000000000000011
11000000000000000000000000000011
11000016610000000000000000000011
11000011110000000000000000000011
