11000000000000000000000000000011
11000000000000000000000000000011
11111100000000000000000000000011
11111100000000000000000000000011
11000000000000000000000000000011
11000000000000000000000000000011
11111111111111111166661111000011
11111111111111111111111111000011
11440000001100000000000000000011
11440000001100000000000000000011
11111100001100000000000000111111
11111100001100000000000000111111
11000000001100000000000000000011
11000000003300000000000000000011
11000011111111111100001111111111
11000011111111111100001111111111
11000000001100000000000000000011
11000000001100000000000000000011
11111111111100000011110000000011
11111111111100000011110000000011
11000000001100000000000000000011
11000000003300000000000000000011
11111111001111111111110000111111
11111111001111111111110000111111
11440011000000000000000000004411
11440033000000000000000000004411
11111111110000000000001111111111
11111111110000000000001111111111
11000000000000000000000000000011
11000000000000000000000000000011
11111111111111666611111111000011
11111111111111111111111111000011
