11000000000000001100000000000011
11000000000000003300000000000011
11000011111111111111111111000011
11000011111111111111111111000011
11000000000000000000110000000011
11000000000000000000110000000011
11111100000000000000110000111111
11111100000000000000110000111111
11440000000000000000110000004411
11440000000000000000330000004411
11111111110000111111111111111111
11111111110000111111111111111111
11000000000000000000000000000011
11000000000000000000000000000011
11111111111111111111111111111111
10000000000000000000000000000001
10000000000000000000000000000001
11111111111111100000000000000001
00000000000000100000000111100001
00000000000000100111111111111111
00000000000000100100000000000011
00000000000000100100000000000011
00166111110000100100000000000011
11111100010011100100000000000011
00100000010000100100000000004411
00111110010000100100000000004411
00000010010000100104440000111111
00000010011100110104440000100001
00000010010000110111111111100001
00000010010000110000000111000001
61000010010000110000000000000001
11110010010011111111111111111111
