11000000000000000000000000000011
11000000000000000000000000000011
11000000000000000000000000111111
11000000000000000000000000111111
11000000000000000000000000000011
11000000000000000000000000000011
11000011116666111111111111000011
11000011111111111111111111000011
11000000000000000011000000000011
11000000000000000011000000000011
11111100000000000011000000111111
11111100000000000011000000111111
11000000000000000011000000000011
11000000000000000011000000000011
11111111111111000011111111111111
11111111111111000011111111111111
11000000001100000000000000000011
11000000001100000000000000000011
11000000001100111100000000000011
11000000001100111100000000000011
11000000001100000000000000000011
11000000003300000000000000000011
11111100001111111111111111000011
11111100001111111111111111000011
11440000000000000000000000000011
11440000000000000000000000000011
11111111110000000000000000111111
11111111110000000000000000111111
11000000000000000000000000000011
11000000000000000000000000000011
11111111111111111111111111111111
11111111111111111111111111111111
