11000011110000111111111111111111
11000010110000100000000000000001
00000010110000100000000000000001
00001110111100100111111111111111
00000010010000100100000000000011
00000010010000101100000000000011
61166110010000101100000000000011
11111100010011101100000000000011
10000000010044100144000000000011
11111110010044100144000000000011
00000010011111100111110000044411
00000010000000000000010000044411
00000010000000000000011111111111
00000010000000000000000000000011
11111110000000000000000000000001
10000000000000000000000000000001
10000000000000000000000000000001
10000000000000000000000000000001
10000000000000000000000000000101
11111111111111111111111111111111
00000000000000000000000000000011
00000000000000000000000000000011
00000000000000000000000000000011
00000000000000000000000000000011
00000000000000000000000000004411
00000000000000000000000000004411
00000000000000000000000000111111
00000000000000000000000000100001
11111111111111111111111111100001
10000000000000000000000000000001
10000000000000000000000000000001
11111111111111111111111111111111
