11000000000000000000000000000011
11000000000000000000000000000011
11111100001661000000000000000011
11111100001111000000000000000011
11000000000000000000000000000011
11000000000000000000000000000011
11000016610000111100000000000011
11000011110000111100000000000011
11000000000000000000000000000011
11000000000000000000000000000011
11111100001111000016610000000011
11111100001111000011110000000011
11000000000000000000000000000011
11000000000000000000000000000011
11000011110000111111111111000011
11000011110000111111111111000011
11000000000000000000000000000011
11000000000000000000000000000011
11111100001661111111110000000011
11111100001111111111110000000011
11000000000000000000000000000011
11000000000000000000000000000011
11111111111111111100001111000011
11111111111111111100001111000011
11000000000000000000000000000011
11000000000000000000000000000011
11000011111111000016611111000011
11000011111111000011111111000011
11000000000000000000000000000011
11000000000000000000000000000011
11166111110000166111110000000011
11111111110000111111110000000011
