11000000000000111111110000111111
11000000000000100111110000100111
11000000000000100100000000100100
11000000000000100100000011100100
11000000000000100100000000110100
11000000000000101100000000100100
11000000000000101100001661100116
11000000000000101100111111000011
11000000000000100100001000000001
11000000000000100100001111111111
11000000000000100100000000000000
11000000000000100111000000000000
11000000000000100100000000000000
11000000000000100100000000000000
11000000000000100111111111111111
11000000000000100000000000000001
11000000000000100000000000000001
11000000000000100000000000000001
11000000000000100100000000000001
11000000000000100111111111111111
11000000000000100100000000000000
11000000000000100100000000000000
11000000001111100100000000000000
11000000001111100100000000000000
11000000000044100144000000000000
11000000000044100144000000000000
11000000001111100111110000000000
11000000001111100000010000000000
11000000000000100000011111111111
11000000000000100000000000000001
11111111111111100000000000000001
11111111111111111111111111111111
